...#E#D..D
......DDD.
D.#D..D#.D
D........D
D#DDDDD#.D
#D#....DDD
.DDD##D.DD
D..D.D..DD
....DDD.#D
.#D#S#DDD#