################################
#####.#..###..E...###....#######
#####............####.##..######
#.D##.....###.#..D....##.#######
##.##..##..##.####.##..##....###
##...#.##...#...##...#.####.####
####....###..##.####....###..###
##.####.####.#..##.####.####.###
#...###..##.D..#....###..##.D..#
###.####..#.##.####.####..#.##.#
###....##..D##.####....##..D##.#
######.###.###D........###.###D#
######....D###.#######....D#####
###########....##########.....S#
################################